1M11111111
1000100001
1000110101
1011100101
1010101101
1010000101
1010110101
1010100101
100010010X
1111111111